6 12
6 0 0 6 5 0 0 1 0 6 4 4 
0 3 0 0 2 0 0 0 0 0 0 2 
0 6 2 0 1 0 2 0 2 0 0 0 
4 1 1 0 6 0 0 2 0 0 0 0 
1 0 0 4 0 0 0 0 6 0 0 6 
5 2 0 6 4 0 3 0 0 0 0 0 
